8 8
6 0
xxxxxx x
x    x x
x    xxx
x      x
x      x
x      x
x      x
xxxxxxxx
